##########
#S       #
# ###### #
#      # #
# #### # #
# #    # #
# # #### #
#      #E#
# ####   #
##########
